111111111
1PC000001
10E0000M1
10C000001
111111111
