1111111111111
1P00001000001
1011101011101
1000101000101
11101011101C1
100010M000111
1011101011101
101M001000001
1C10111110101
1000000000E01
1111111111111