111111111111111111111111
1000E0000000000000000001
100P00000000000000000001
11111000000000000000M001
100000000000000000000001
1C00C0000000000000000001
100000000000000000000001
10000000000000000000M001
10000M000000000000000001
100000000000000000000001
111111111111111111111111
