111111111
1P0000001
100010E01
100C10001
111111111
