111111111
1P00000E1
100010001
100C10001
111111111
