111111111
1PEC00C01
100000C01
111111111