111111111111111111111111
1000E00000MMMMMM00000001
100P00000000000000000001
111110000000000000000001
100000000000000000000001
1C00C00000000000000M0001
100MMMMMM000000000000001
100000000000000000000001
100000000M00000000000001
100000000000000000000001
100000MMMMMMMMMMMMMMMMM1
100000000000000000000001
111111111111111111111111
