111111111111111111111111
1000E0000000000000000001
100P00000000000000000001
111110000000000000000001
100000000000000000000001
1C01C0000000000000000001
101000000000000000000001
100000000000000000000001
100000000000000000000001
100000000000000000000001
100000000000000010000001
100000000000000000000001
111111111111111111111111
