111110111
1P00100E1
100000001
100010C01
111111111
