111111111111111111
100CP0000000000001
10E010001111100001
100010001000000001
100010001000000001
100010001000000001
100011111111100001
100000001000100001
1000000M1000100001
100000001000100001
100011111000100001
100000000000000001
111111111111111111