111111111111111111
1000P000000000C001
10E010001111100001
100C1000100C00C001
100C1000100C00C001
100C1000100C00C001
100C111111111C0001
100C0000100C1C0001
100C0000100C1C0001
100C0000100C1C0001
100C1111100C10C001
10000000000000C001
111111111111111111